{
  "level": 2,
  "board": [
    [6, 6, 6, 6, 6, 3, 6],
    [5, 6, 6, 6, 6, 6, 6],
    [6, 6, 0, 6, 5, 6, 6],
    [6, 6, 6, 6, 6, 6, 6],
    [6, 6, 3, 6, 5, 6, 6],
    [6, 6, 6, 6, 6, 6, 0],
    [6, 1, 6, 6, 6, 6, 6]
  ]
}