{
  "level": 3,
  "board": [
    [6, 6, 6, 6, 6, 6, 6],
    [6, 6, 2, 5, 6, 6, 6],
    [6, 6, 6, 6, 6, 2, 6],
    [6, 5, 6, 3, 6, 5, 6],
    [6, 0, 6, 6, 6, 6, 6],
    [6, 6, 6, 0, 1, 6, 6],
    [6, 6, 6, 6, 6, 6, 6]
  ]
}